#  .  #  #  #  #  #
#  .  #  .  .  .  .
#  .  #  .  #  .  #
#  .  #  .  #  .  #
#  .  #  .  #  .  #
#  .  .  .  #  .  #
#  /  #  #  #  #  #