#  #  #  #  #  #  #  
#  .  #  .  .  .  #  
#  .  #  .  #  .  #  
.  .  #  .  #  .  .  
#  .  #  .  #  .  #  
#  .  .  .  #  .  #  
#  #  #  #  #  #  #  
